WWWWWWWWWWWWWWWWWWWWWWWWWWWWWWWWWWWWWWWWWWWWWWWWWWWWWWWWWWWWWW
WWWWWWWWWWWWWWWWWWWWWWWWWWWWWWWWWWWWWWWWWWWWWWWWWWWWWWWWWWWWWW
WW             #              #             #               WW
WW W W WWWW WWW W WW#WWW WW WW WWW W WWWWWWW WWWWWWWWW W WW WW
WW W W  #   W   W           WW W   W W       WWWWWWWWW W WW WW
WW#W WWWWWW W WWW WWWWWWWWW WW W WWW W WWWWWW     #         WW
WW       WW W WWW              W WWW W W  #WWWWWWW WWWWWW W WW
WW WWWWW WW W WWWWWW WWWWWW WWWW   W W WWW#WWW WWW WWWWWW W WW
WW     W          #       W WWWWWW W W        #           W#WW
WW WWW  W WWWW WW WWWWWWW W      W W WWWWWWWWWWWWWWWWWWWW W WW
WW#WWWW W WWWW WW WWWWWWW WWWWWW W W W                WWW W WW
WW        WWWW W        ##       W W#W WWWWWWWWWWW ## WWW W WW
WW W WWWW W    W WWWWWWWWWWWWWWW  #W W WWWWW              W WW
WW W  #   WW WWW W  # #WWWWWWWWW WWW W W   W WWWWWWWWWWWWWW#WW
WW WWWWWW WW WWW W# # #WWW      A    W WWW W        WWWWWWW WW
WW        ##     W # # WWW WWWWWW WWWW WWW WWWWWWWW WWWWWWW WW
WW WWWWWWWWWWWWWWW # # WWW WWWWWW#WWWW WWW WWWWWWWW       W WW
WW#             WW# ## WWW W      W              WWWWWWWW W#WW
WW WWWWW#WWWWWW W      WWW W WWWWWW WWWWWWWWWWWW        W W WW
WW WWWWW#WWWWWW W WWWW WWW W    W     W        W WWWWWW W W WW
WW W            W WWWW WWW WWWW W ### W W WWWW W WW       W#WW
WW#W W WWWWWWWWWW WWWW WWW            W W  # W W WW WWWWWWW WW
WW W W               W     WWWWWWWWWWWW W #  W W WW      WW WW
WW W WWWWWWWWW WWWWWWWWWWWWWWWWWWWWWWWW WWWWWW W WWW WWW WW WW
WW           #             #             #                  WW
WWWWWWWWWWWWWWWWWWWWWWWWWWWWWWWWWWWWWWWWWWWWWWWWWWWWWWWWWWWWWW
WWWWWWWWWWWWWWWWWWWWWWWWWWWWWWWWWWWWWWWWWWWWWWWWWWWWWWWWWWWWWW